111111
1E0001
1C0001
1000P1
10Z0E1
111111
