111111111111
1E00000000P1
10000P000001
1C00E00Z0001
111111111111
