
11111111111111111111111111111
1000E000000000000000000000001
100Z0000000000000000000000001
1P000000000000000000000000001
1000C000000000000000000000001
10000000000000000000000000001
10000000000000000000000000001
11111111111111111111111111111
