11111111111111111111111111111
1000E000000000000000000000001
10000000000000000000000000001
1P0000000000Z00ZZ000000000001
1000C000000000000000000000001
10000000000000000000000000001
100000000000000000000000000c1
11111111111111111111111111111
