11111111111
1P000000E11
10110010101
1E110001111
11111111111
