11111111111
1P000000011
101100C0101
1C1C0001ZE1
11111111111
