11111111111
1P000000011
101100C0111
101C00Z0CC1
11111111111
