11111111111
1000Z00E101
1C1C1000111
11111111111
