1111111111111111
10000P0000000111111
10001000C00001
10001100100001111111
1Z00E11C1C0001111
11111111111111
