11111111111111111111
1P000000000000C00001
1ZZZZZZZZ1ZZZZZZZZE1
11111111111111111111
