1111111111111111111111111111
1C000000000001100000000000C1
1011110111110110111110111101
101111C11111011011111C1ZZ101
1011110111110110111110111101
1Z00P00000000000000000000001
10111101101111111101101111E1
101111011011111111Z11Z111101
1111111111111111111111111111
