1111111111111111111111
1C000000000000000000P1
1011111111111111111111
101C0000000000000000C1
10101111Z1111111111101
10Z01E000000000000C101
10101Z1111111111110101
101C00000000000000C101
10111111Z1111111111101
1C000000000000000000C1
1111111111111111111111
