1111111111111111111111111111111111
1E0000000000000C00000C000Z00000001
1010010100100000101001000000010101
1010010010101010001001000Z00010101
1P0000Z00C0ZC00Z0000Z00000000000C1
1111111111111111111111111111111111
