1111111111
1P00000001
1C10101011
1C1C1C1C11
1000000001
1000000001
10000Z0001
10010E0101
1000000001
1111111111
