1111111111
1P00000001
10C0000001
100E000001
1000Z00001
1000000001
1000000001
1000000001
1000000001
1111111111
