11111
10000
10001
10001
1PCE1
11111
