11111111111111111111111
1P0000000000000C000E001
11111111111111111111111
