11111111111111111111111
1P000E000000000C0000001
11111111111111111111111
