1111111111
1P00000001
100C1C1001
101CC1CC01
1001111CE1
1111111111
