1111111111111111
1P0011C100001C01
111C000100001101
1000110100000101
10000C0001C000C1
10000C0001000CC1
10000C0001CC0001
10000C0001C000C1
1C111E1001C000C1
1111111111111111
