11111111111111111111
1P000000000000C00001
100000000100000000E1
11111111111111111111
